#########      #################    ##########         #####
#.......#      #..........G...W#    #Pb...b..###########...#
#.......########..........######    #...b.b..G.......G..B..#
#...@B...................r#         #..b.....###########...#
#.......########..........#         #........#         #####
#.......#      #..........#         #####.####
#.......#      #..........#             #.#
####.####      ############      ########.########
   #.#                           #...............#
   #.#                           #.#############.#
   #.#                           #.#           #.#
   #.#                           #.#        ####.####  #####
####.#######      ################.###      #.......####..A#
#..b.b.....#      #.................F#      #...E...G....###
#...b......#      #......r.........r.#      #.......######
#..........########..r........r......#      ####.####
#........................r........r..#         #.#
#..........########...r........r.....###########.##
#..........#      #........r........r.....b.......#
############      #################################