          ######### ###################################
          #.......# #.................................#
          #.#####.###.###########################.#...#####
          #...#.......#           #.....#.........#.......#
          #.#.#...#####           #.....#.#########...#...###
          #.#.#...#               #.....#.#       #...#.....#
#######   #.#.#####             ###.....#.#       #...#...#.#
#..@..#   #.#.#                 #.......#.#       #...#...#.#
#.....#   #.#.###################.#.....#.#########...#...#.#
#.....#   #.#.......#...#.......#.#.....#.........#...#...#.#
###.##### #.#.......#...#.......#.#####.#########.#########.#
  #.....# #.#...........#.......#.# #...#   #...............#
  #.....###.#.......#...###.#####.# #...# ###.#####.......#.#
  #.....#...#.......#.............# #...# #.......#########.#
  #.....#...#.#########.########### #...# #.......#   #.E.#.#
  #.....#...#.........#.....#.....# #...# #.......#   #.B.#.#
###.#####...#########.###...#.....# #...# #.......######.##.#
#.......#...#   #.......#...#.....# #...# #.......#.......#.#
#...###.#########.......#...#.....# #.#####.......#.#######.#
#...# #.................#.........# #.............#.........#
##### ############################# #########################