#############################################
#...#.......#.....#.....#...#.........#.....#
#.#.#.......#.###.#.....#.#.#.#######.#.###.#
#.#@#.......#...#.......#.#.........#...#...#
#.###.......###.###.....#.###############.#######
#...........# #.# #.....#.#.............#.......#
#.#######.#####.###.....#.#.###########.#.......#
#.#.....#.....#.#.......#.#.#     #.....#.......#
#.#.#####.###.#.#.#####.#.#.#######.###.###.#####
#.#...#...#...#.#.....#.#.#.#.......#.......#
#.###.#.#######.#.###.#.#.#.#.......#.......#
#.....#.......#.#.# #.#...#.#.......#.......#
#####.#######.#.#.# #.#####.#.......#.......#
#.....#.....#.#.#.# #...#...#.......#.......#
#.#########.#.#.#.# #.#.#.###.......#.......#
#.# #.......#.#.#.# #.#.#...................#
#.###.#####.#.#.#.###.#.#####################
#.....#.....#.#.#...#.#.#...........#.......#
#######.#####.#.###.#.#.#.#.#.......#.......#
#.....#.#...#.#.#...#.#.#.#.#.......#.......#
#.#.###.###.#.#.#####.#.###.#.......#.......#######
#.#.........#.#.......#.....#.......#.............#
#.###########.#.......#######.......#.......#####.#
#.# #.......#.#.......#.....#...............#...#.#
#.# #.......#.#.......#.###.#.###############.#.#.#
#.# #.......#.#.......#.#.#.#.....# #...#.....#.#.#
#.#######.###.#.#####.#.#.#.#.....###.###.###.#.#.#
#.........#.....# #...#.#...#.......#...#.# #.#.#.#
###########.##### #...#.#####.....#.#.#.#.# #.###.#
#.....#   #...#   #...#.....#.....#.#.#.#.# #...#.#
#.###.#######.#####...#.....#.....#.###.#.# #...#.#
#.# #.........#.......#...........#.....#.# #.....#
#.#############.###...#.....#####.#######.# #...###
#.................#...#.........#.........# #...#
#.###################.#.....###.#################
#.#.......#...........#.....# #...#.......#
#.#######.#.#####################.#.#.....#
#.........#.........................#.....#
###########################################