#########        #############   ###  ###########
#.......#        #...........#   #.#  #.........#
#.#####.##########.#######.#.#####.####.#####.#.#
#.#...#............#.....#.#..........#.#...#.#.#
#.#.#.##############.###.#.##########.#.#.#.#.#.#
#...#.#            #.#...#.#        #.#...#.#...#
#####.#            #.#.###.#        #.#####.#####
#.....#      #######.#.....#  ##### #.......#EB.#
#.#####      #.......#####.#  #...# ##.####.###.#
#.#          #.#####.......#  #.###  #.#  #.....#
#.#    #######.#   #######.#  #.#    #.#  #######
#.#    #.......#         #.#  #.#    #.#
#.#    #.#######         #.####.######.#
#@######.......#         #.............#
#..............#         #.............#
################         ###############