                              #####################
                              #...#...............#
  #############################...#...#.###.#####.#
  #.....#.........................#...#.# #...# #.#
  #..@..#.....#.....#######...###.#####.###...# #.#
  #.....#.....#.....#.....#...# #...# #...#...# #.#
  #.....#.....#.....#.#...#...###...# ###.###.###.#
  #.....#.....#.....#.#...#.....#...#   #.....#...#
#####.###.#####.#####.#########.#...#####.....#...#
#.....# #.........#.......#.....#.......#.....#...#
#.....# #.....#...#.#####.#.#####.###...###.#.#...#
#.....# #.....#...#.# #...#.......# #.......#.#...#
#.....# #.....#.###.###.###.#.....# #####...#.#####
#.....# #.....#.....#.....#.......#     #...#.....#
#.###.###############.....###############...#####.#
#.#.....#.....#.............................#...#.#
#.#.....#.....#.....###.###.#################...#.#
#.#.....#...........# #.# #.......................#
#.#.....#.....#.....###.#####.....#.....###.#...#.#
#.............#...................#.........#.....#
###################################################